00000000000000000000000000000000
00000000000000000000000000000000
00000000000000000000000000000000
00000000000000000000000000000000
00000000000000000000001000000000
00000000000000000000010100000000
00000001100000000000101000000000
00000010010000000000100000000000
00000101001000000001000000000000
00000010000100000001000000000000
00000000000010000001000000000000
00000000000001000001000000000000
00000000011111000001000000000000
00000000100000111001111100000000
00000000100000100110000010000000
00000000100100100010000010000000
00000000100000100010010010000000
00000000011111000010000010000000
00000000100000000001111100000000
00000001000000000000000100000000
00000001000000000000000010000000
00000001000011100011000010000000
00000001000010011101000010000000
00000011000001000010000010000000
00000101000000111100000100000000
00001010100000000000001000000000
00010101010000000000010000000000
00101010001000000000100000000000
01010100000111111111000000000000
10101000000000000000100000000000
01011000000000000000010000000000
10101000000000000000001000000000
